BRICK=
2,1;2,3;2,5;2,7;2,9;2,11;
3,1;3,3;3,5;3,7;3,9;3,11;
4,1;4,3;4,5;4,7;4,9;4,11;
5,1;5,3;5,5;5,7;5,9;5,11;
6,1,0;6,3,0;6,5,1;6,7,1;6,9,0;6,11,0;
7,2,1;7,3,1;7,5,0;7,7,0;7,9,1;7,10,1;
8,2,0;8,3,0;8,5,1;8,7,1;8,9,0;8,10,0;
9,1,1;9,3,1;9,5;9,6;9,7;9,9,1;9,11,1;
10,1;10,3;10,5;10,7;10,9;10,11;
11,1;11,3;11,5,0;11,7,0;11,9;11,11;
12,1;12,3;12,9;12,11;
IRON=4,6;8,0,0;8,12,0;
ENEMYTank_SPEED = 7;
ENEMYTANK_ARMOR =6;
ENEMYTANK_NORMAL_=7;